11111111111
100000000E1
10P00000001
10000C00000
10000000000
11101111111