111111111
1P00C0001
111000001
1000CX111
10XC000E1
111111111